###########
####    ###
# @    @  #
#   A@    #
###### ####
###########
