####################
#        ###########
## ## # ############
## #     ##########
## #   @  ##########
## ##   #   ########
## ##  #  @ #####
## ##    ##  #######
## #    OO    #####
#       OO@ ########
#    # #############
## @# #############
##   # #############
## A# #############
####################
