################################
#                              #
#       A                      #
#                              #
#                              #
#                  @           #
#      #                       #
#      #   @        O          #
#      #                       #
#      #                   O   #
#                   O          #
#                              #
#                  @           #
#                              #
################################
