################################
#                              #
#       A                      #
#                              #
#                              #
#                  A           #
#      #                       #
#      #   @                   #
#      #                       #
#      #                   O   #
#                              #
#                              #
#                  A           #
#                              #
#                              #
#                              #
#                              #
#                              #
#           @                  #
#                              #
#                              #
################################