#########      ###
### ####        #
### #############
### ###         #
### A  @ ########
######   ###### #
######    O     #
#################