###########
####    ###
# O@  A@  #
#   @O    #
###### ####
###########
