###########
####    ###
# O@A @O  #
#   @O    #
###### ####
###########
